#clock 5
#spawn cycle 1 2
WWWWWWWWWWWWWWWWWWWWWWW
W                     W
W         W           W
W W                   W
W   BBBBBBBBBBBBBBB   W
W   BBBBBBBBBBBBBBB W W
W   BBBBBBBBBWBWBBB   W
W   BBBBBBBBBBBBBBB   W
W   BBBBBBBBBBBBBBB   W
W   BBBWBWBBBBBBBBB   W
W   BBBBBBBBWBBBBBB   W
W   BBBBBBBBBBBWBBB   W
W   BBBBBBBBBBBBBBB   W
W   WBBBBBBBBBBBBBB   W
W   BBBBBBBBBBBBBBB   W
W   BBBBBBBBBBBBBBB   W
W   BBBBBBBBBBWBBBB   W
W   WBBBBBBBBBBBBBB   W
W  WWBBBWBBBBBBBBBW   W
W             W       W
W      W    W         W
W                     W
WWWWWWWWWWWWWWWWWWWWWWW