WWWWWWWWWWWWWWWWWWWWWWW
W                     W
W                     W
W                     W
W   BBBBBBBBBBBBBBB   W
W   BBBBBBBBBBBBBBB   W
W   BBBBBBBBBBBBBBB   W
W   BBBBBBBBBBBBBBB   W
W   BBBBBBBBBBBBBBB   W
W   BBBBBBBBBBBBBBB   W
W   BBBBBBBBBBBBBBB   W
W   BBBBBBB BBBBBBB   W
W   BBBBBBBBBBBBBBB   W
W   BBBBBBBBBBBBBBB   W
W   BBBBBBBBBBBBBBB   W
W   BBBBBBBBBBBBBBB   W
W   BBBBBBBBBBBBBBB   W
W   BBBBBBBBBBBBBBB   W
W   BBBBBBBBBBBBBBB   W
W                     W
W                     W
W                     W
WWWWWWWWWWWWWWWWWWWWWWW